NO texture/north.png
SO texture/south.png
WE texture/west.png
EA texture/east.png
F 255,200,200
C 255,255,250

111111
100S01
111111
