NO texture/north_test.png
SO texture/south_test.png
WE texture/west_test.png
EA texture/east_test.png
F 220,111,119
C 225,111,0

111111111111111111111111111111111111111111111111111111111111111111111111111111111111111111111111111111111111111
100000000000S000000000000000000000000000000000000000000000000000000000000000000000000000000000000000000000000001
 10000000000000000000011111111111111111111111111111111111111111111111111111111111111111111111111111111111111111
  10000000001000000001
   100000000000000001
    1000000000000001
     10000000000001
      100000000001
       1000000001
        10000001
         100001
          1001
           11
