NO texture/north.png
SO texture/south_test.png
WE texture/west_test.png
EA texture/east_test.png
F 220,111,119
C 225,111,0

111111111111111111111
1000000000000000X0001
1000000000000000S0001
111111111111111111111
