NO texture/north.png
SO texture/south.png
WE texture/west.png
EA texture/east.png
F 0,147,32
C 82,229,255

 1111111111111111111111
100000000000E00000000001
 1000000001000000000001
  10000000010000000001
   100000000000000001
    1000000000000001
     10000000000001
      100000000001
       1000000001
        10000001
         101101
          1001
           11

